25 25
!#######################!
!#          #          #!
!# ## ##### # ##### ## #!
!#          @          #!
!# ## # ######### # ## #!
!#    #     #     #    #!
!#### ##### # ##### ####!
!!!!# #           # #!!!!
##### # # ## ## # # #####
#       # # @ # #       #
##### # # ##### # # #####
!!!!# #       .   # #!!!!
!#### # ######### # ####!
!#          #          #!
!# ## ##### # ##### ## #!
!#  #       .       #  #!
!## # # ######### # #  #!
!#    #$    #     #    #!
!# ####### ### ####### #!
!# #     #     #     # #!
!# # ### ## # ## ### # #!
!# # #      #      # # #!
!# # # #### # #### # # #!
!#     .    #          #!
!#######################!