25 25
!#######################!
!#..........#..........#!
!#.##.#####.#.#####.##.#!
!#..........@..........#!
!#.##.#.#########.#.##.#!
!#....#.....#.....#....#!
!####.#####.#.#####.####!
!!!!#.#...........#.#!!!!
#####.#.#.##.##.#.#.#####
#.......#.#.@.#.#.......#
#####.#.#.#####.#.#.#####
!!!!#.#...........#.#!!!!
!####.#.#########.#.####!
!#..........#..........#!
!#.##.#####.#.#####.##.#!
!#..#...............#..#!
!##.#.#.#########.#.#..#!
!#....#$....#.....#....#!
!#.#######.###.#######.#!
!#.#.....#.....#.....#.#!
!#.#.###.##.#.##.###.#.#!
!#.#.#......#......#.#.#!
!#.#.#.####.#.####.#.#.#!
!#..........#..........#!
!#######################!