55 23
#######################################################
#######################################################
##$#...........#.........#.......................#...##
##.#.#########.#.#####.#.#####.#################.#.#.##
##.#...#.#..... .#.....#.......#...#.........#.#.#.#.##
##.###.#.#.## ####.###### ######.###.### #.#.#.#...#.##
##.....#.#.......#.#.....#...#.......#.....#...#.#.#.##
########.#######.#.#.###.#.#.###.#####.#######.#.###.##
##.......#.......#.....#...#...#...#...#...#...#...#.##
##.#######.#### #### #########.#####.###.###.#####.#.##
##.........#...#.......#.......#.....#...#...#.....#.##
##.### ##.##............... ..##### ##...............##
##.......#...#.#.#.#...#.#...#...#.....#.....#.#...#.##
########.###.#. .#.#.###.#.###.#.#####.#.#####.#.#.#.##
##.#...#.....#.#.#.#.....#.#...#.#...#...#.#...#.#...##
##.#.#.## ####.###.#######.#.###.#.#.#.###. .###.###.##
##...#.......#...#.#.........#.#...#.#.....#.#...#.#.##
##.#######.#####.#.#.#########.#####.## ##.#.#.###.#.##
##.#.....#.#...#.#.#.........#...#...#...#.#.#...#.#.##
##.#.###.#.#.#.#.#.#########.###.#.###.#.###.###.#.#.##
##... ...#...#.....#.............#.....#.........#..@##
#######################################################
#######################################################