17 17
#################
#               #
#               #
#  ###########  #
#  #         #  #
#  #         #  #
#  #         #  #
#  #         #  #
#  #         #  #
#  #         #  #
#  #         #  #
#  #         #  #
#  #         #  #
#               #
#               #
#               #
#################