40 40
########################################
#..................#..................##
#.#######.##.#####.#.########.###.###.##
#.........##...###.#.########.###.###.##
#.#######.####.###.#..........###.###.##
#.#######.####.###.#.########.###.###.##
#................@....................##
#.#######.#####.#######.#####.#######.##
#.#######.#####.#######.#####.#######.##
#....####....##....#....##....####....##
#.##......##.#####.#.#####.##......##.##
#.#######.##.#####.#.#####.##.#######.##
#.##.........#####.#.#####.........##.##
#....####.##...............##.####....##
#########.##.##.###.###.##.##.##########
#########....##.#.....#.##....##########
############.##.#.@...#.##.#############
############.##.#....@#.##.#############
############.##.###.###.##.#############
############...............#############
############.##.#######.##.#############
############.##.#######.##.#############
############.##.........##.#############
############.##.###.###.##.#############
############.##.###.###.##.#############
#.....................................##
#.#######.##.#############.##.#######.##
#.#######.##.#############.##.#######.##
#......##.##......###......##.##......##
######.##.##.####.###.####.##.##.#######
######.##.##.####.###.####.##.##.#######
#......##.##.####.###.####.##.##......##
#.####.##.##...............##.##.####.##
#.####.##....#############....##.####.##
#$####.#####.#############.#####.####.##
#.####............###............####.##
#.####.##########.###.##########.####.##
#.####.##########.###.##########.####.##
#.....................................##
########################################
########################################