6 6
######
#  # #
#  # #
#. # #
#  # #
######